WWWWWWWWWWSSSSSSSWWWWWWWWWWWWWWW
WSSSSSSSSS       SSSSSSSSSSSSSSW
WSSSSSSSSS        SSSSSSSSSSSSSW
WS   WWWWW          D         SW
WS   W   W  W W  WWWWWW       SW
WS   W   W                    SW
WS   WB    W W                SW
WS   WWWWWWWS  W              SW
WS               W            SW
WS           W                SW
WS                            SW
WS                            SW
WS                            SW
WS                  B         SW
WS    P   W      WWWW         SW
WS  WWWWW     W               SW
WSSSSSSSSSSSSSSSSSSSSSSSSSSSSSSW
WWWWWWWWWWWWWWWWWWWWWWWWWWWWWWWW
:F fondo_test2.png
:W wall1.png