WWWWWWWWWWWWWWWWWWWWWWWWWWWWWWWW
W                              W
W                              W
W                              W
W                              W
W                              W
W                              W
W                              W
W                              W
W                              W
W                              W
W                              W
W                              W
W                              W
W                              W
W                B             W
WP               BB           DW
WWWWWWWWWWWWWWWWWWWWWWWWWWWWWWWW
#fondo_test2.png
