WWWWWWWWWWWWWWWWWWWWWWWWWWWWWWWW
WSSSSSSSWSSSSSSSSSSSSSSSSSSSSSSW
WW      S   S       S         SW
WW                            SW
WWP                      D    SW
WWWWB W   W     W    WWWWWWWWWSW
WSSSSSSSSSSSSSSSSSSSSSSSSSSSSSSW
WS                            SW
WS                            SW
WS                            SW
WS                            SW
WS                            SW
WS                            SW
WS                            SW
WS                            SW
WS                            SW
WSSSSSSSSSSSSSSSSSSSSSSSSSSSSSSW
WWWWWWWWWWWWWWWWWWWWWWWWWWWWWWWW
#fondo_test2.png
