WWWWWWWWWWWWWWWWWWWWWWWWWWWWWWWW
W     W W      W               W
W WW  W W      W               W
W     WWW      W               W
W         B    W               W
WW     B       W               W
W    P   B     W               W
WWWWWBBBWW W  WW               W
W   W        W W               W
W   W       W  W               W
W   W      W   W               W
WW  WWWWWWWWWWWW               W
W                              W
W                              W
W                              W
W                              W
W                              W
WWWWWWWWWWWWWWWWWWWWWWWWWWWWWWWW
#fondo_0.png