WWWWWWWWWWWWWWWWWWWWWWWWWWWWWWWW
W                              W
W                              W
W P          B                 
WWWWWWWWWWWWWWWWWWWWWWWWWWWWWWWWWWWWWWWWWWWWWWWW
W                              W
W                              W
W                              W
W                              W
W                              W
W               WWW            W
W             W W              W
W           W W W              W
WWWWW W W W W W W              W
WS                             W
W   S            S       S     W
WSSSSSSSS SSSSSSSSSSSSSSSSSSSSSW
WWWWWWWWWWWWWWWWWWWWWWWWWWWWWWWW
#fondo_test0.png