WWWWWWWWWWWWWWWW
W      W       W
W     DW  B    W
W     WWW      W
W B            W
W              W
W              W
WW  W  WW  W  WW
W            W W
W           W  W
W        P W   W
WWWWWWWWWWWWWWWW
#fondo_test2.png