W     WWW      W
W      W       W
W      W       W
W     WWW      W
W              W
W              W
W              W
WW  W  WW  W  WW
W            W W
W           W  W
W        I W   W
WWWWWWWWWWWWWWWW
fondo_2.png