WWWWWWWWWWWWWWWWWWWWWWWWWWWWWWWW
WSSSSSSSWSSSSSSSSSSSSSSSSSSSSSSW
WW      S   W       S         SW
WW                            SW
WWP                      D    SW
WWWWB W   W     W    WWWWWWWWWSW
WSSSSSSSSSSSSSSSSSSSSSSSSSSSSSSW
WS                            SW
WS                            SW
WS                            SW
WS                            SW
WS                            SW
WS                            SW
WS                            SW
WS                            SW
WS                            SW
WSSSSSSSSSSSSSSSSSSSSSSSSSSSSSSW
WWWWWWWWWWWWWWWWWWWWWWWWWWWWWWWW
:F fondo_test0.png
:M cheetah2.mp3