WWWWWWWWWWWWWWWWWWWWWWWWWWWWWWWW
WWWWWWWW    WWWWW        WWWWWWW
WBBBWWWW    WWWWW             DW
W   WWWW  W            WWWWWWWWW
W WWWWWW  W            WWWWWWWWW
W         W            WWWWWWWWW
W P WWWW  W  WWWWW     WWWWWWWWW
WWWWWWWWWWWWWWWWWWWWWWWWWWWWWWWW
WS                            SW
WS                            SW
WS       S             S      SW
WS                            SW
WS         W         W        SW
WS          WWW   WWW         SW
WS             WWW            SW
WS                            SW
WSSSSSSSSSSSSSSSSSSSSSSSSSSSSSSW
WWWWWWWWWWWWWWWWWWWWWWWWWWWWWWWW
#fondo_test2.png
