WWWWWWWWWWWWWWWW
W     W W      W
W WW  W W      W
W     WWW      W
W         B    W
WW             W
W   I    B     W
WWWWWBBBWW W  WW
W   W        W W
W   W       W  W
W   W      W   W
WW  WWWWWWWWWWWW
#fondo_1.png
