W  P WWWWW     W
W     W W      W
W     W W      W
W    WWWWW     W
W              W
W              W
W              W
WW  W  WW  W  WW
W            W W
W           W  W
W          W   W
WWWWWWWWWWWWWWWW
#