WWWPWWWWWWWWWWWWWWWWWWWWWWWWWWWW
WWW WWWWWWWWWWWWWWWWWWWWWWWWWWWW
WW                 F          WW
WW      F     F     WWWWW  D  WW
WW                      WWWWWWWW
WWWW                    WWWWWWWW
WWG                     WWWWWWWW
WWW                     WWWWWWWW
WW      B    WB   WB    WWWWWWWW
WW      F     F    F    WWWWWWWW
WW                      WWWWWWWW
WW                      WWWWWWWW
WW                      WWWWWWWW
WW                      WWWWWWWW
WW                      WWWWWWWW
WW                      WWWWWWWW
WW                      WWWWWWWW
WW                      WWWWWWWW
:Fondo fondo_marble2.png
:Musica BondEsque.wav
:Pared marble.png
:Graviswitch False
:G_Spin 3