WWWWWWWWWWWWWWWWWWWWWWWWWWWWWWWW
WWWWWWWWWWWWWWWWWWWWWWWWWWWWWWWW
WWWWWWWWWWWWWWWWWWWWWWWWWWWWWWWW
WWWWWWWWWWWWWWWWWWWWWWWWWWWWWWWW
WWWWWWWWWWWWWWWWWWWWWWWWWWWWWWWW
WWWWWWWWWWWWWWWWWWWWWWWWWWWWWWWW
WWWWWWWWWWWWWWWWWWWWB B BBBWWWWW
WWWWWWWWWWWWWWWWW          WWWWW
WWWWWWWWWWWWWWWWW          WWWWW
WWWWWWWWWWWWWBBWW          WWWWW
WWWWWWWWWWWWW  WW             WW
WWWWWWWWWWWWW  WW           D WW
WWWWWWWWWWWWW  WW          WWWWW
WWWWWWWWWWW                WWWWW
WWWWWWWWWWW               WWWWWW
WWWWWWWWWWWW P           WWWWWWW
WWWWWWWWWWWWWWWWWWW     WWWWWWWW
WWWWWWWWWWWWWWWWWSSSSSSSSSSWWWWW
:F fondo_marble2.png
:M cheetah.mp3
:W scrap2.png
:G False