WWWWW WWWWWWWWWWWWWWWWWWWWWWWWWW
WWWWW WWWWWWWWWWWWWWWWWWWWWWWWWW
WWWWWPWWWWWWWWWWWWWWWWWWWWWWWWWW
WWWWW WWWWWWWWWWWWWWWWWWWWWWWWWW
WWWWW WWWWWWWWWWWWWWWWWWWWWWWWWW
WWWWW   F     F  F    F     WWWW
WWWWWWWWW     WWWW    WWWWW WWWW
WWWWWWWWW    BWWWW   BWWWWW WWWW
WWWWWWWWWWWWWWWWWWWWWWWWWWW WWWW
WWWWWWWWWWWWWWWWWWWWWWWWWWW WWWW
WWWWWWWWWWWW WWWWWWWWWWWWWW WWWW
WWWWWWWWWWWW  WWW WWWWWWWW   WWW
WWW            W G WWWWWWW D WWW
WWWWWWWWWWWW  WWWWWWWWWWWWWWWWWW
WWWWWWWWWWWW WWWWWWWWWWWWWWWWWWW
WWWWWWWWWWWWWWWWWWWWWWWWWWWWWWWW
WWWWWWWWWWWWWWWWWWWWWWWWWWWWWWWW
WWWWWWWWWWWWWWWWWWWWWWWWWWWWWWWW
:Fondo fondo_marble2.png
:Musica BondEsque.wav
:Pared marble.png
:Graviswitch False
:G_Spin 1