WWWWWWWWWWWWWWWWWWWWWWWWWWWWWWWW
WW  F                   F      W
WW                      F  D   W
WW                      WWWWWWWW
WW                      WWWWWWWW
WW                      WWWWWWWW
WW                      WWWWWWWW
WW                      WWWWWWWW
WW                      WWWWWWWW
WW                      WWWWWWWW
WW                      WWWWWWWW
WW                      WWWWWWWW
WW                      WWWWWWWW
WW                      WWWWWWWW
GW                      WWWWWWWW
WW P  B                 WWWWWWWW
GWWWWWWWWWWWWWWWWWWWWWWWWWWWWWWW
WWWWWWWWWWWWWWWWWWWWWWWWWWWWWWWW
:Fondo fondo_marble2.png
:Musica BondEsque.wav
:Pared marble.png
:Graviswitch False
:G_Spin 4