WWWWWWWWWWWWWWWWWWWWWWWWWWWWWWWW
WSSSSSSSWSSSSSSSSSSSSSSSSSSSSSSW
WW      S   W       S         SW
WW                  S         SW
WWP                      D    SW
WWWWB W   W     W    WWWWWWWWWSW
WSSSSSSSSSSSSSSSSSSSSSSSSSSSSSSW
WS                            SW
WS                            SW
WS                            SW
WS                            SW
WS                            SW
WS                            SW
WS                            SW
WS                            SW
WS                            SW
WSSSSSSSSSSSSSSSSSSSSSSSSSSSSSSW
WWWWWWWWWWWWWWWWWWWWWWWWWWWWWWWW
:F fondo_marble2.png
:M marble.mp3
:W marble.png