WWWWWWWWWWWWWWWWWWWWWWWWWWWWWWWW
WW  F                   F      W
WW                      F  D   W
WW                      WWWWWWWW
WW                      WWWWWWWW
WW                      WWWWWWWW
WW                      WWWWWWWW
WW                      WWWWWWWW
WW                      WWWWWWWW
WW                      WWWWWWWW
WW                      WWWWWWWW
WW                      WWWWWWWW
WW                      WWWWWWWW
WW                      WWWWWWWW
WW                      WWWWWWWW
WW P  B   G             WWWWWWWW
WWWWWWWWWWWWWWWWWWWWWWWWWWWWWWWW
WWWWWWWWWWWWWWWWWWWWWWWWWWWWWWWW
:Fondo fondo_marble2.png
:Musica BondEsque.wav
:Pared marble.png
:Graviswitch False
:G_Spin 4
#:G_Spin_spd 120