WWWWWWWWWWWWWWWWWWWWWWWWWWWWWWWW
WWWWWWWWWWWWWWWWWWWWWWWWWWWWWWWW
WWWWWWWWWWWWWWWWWWWWWWWWWWWWWWWW
W      WWWWWWWWWWWWWWWWWWWWWWWWW
W        WWWWWWWWWWWWWWWWWWWWWWW
W P  C      WWWWW WWWWWWWWWWWWWW
WWWWWW      WW         WWWWWWWWW
WWWWWWW      W          WWWWWWWW
WWWWWWW                   WWWWWW
WWWWWWWW                  WWWWWW
WWWWWWWWS        WS    D  WWWWWW
WWWWWWWWWWWSWWSSWWWWWWWWWWWWWWWW
WWWWWWWWWWWWWWWWWWWWWWWWWWWWWWWW
WWWWWWWWWWWWWWWWWWWWWWWWWWWWWWWW
WWWWWWWWWWWWWWWWWWWWWWWWWWWWWWWW
WWWWWWWWWWWWWWWWWWWWWWWWWWWWWWWW
WWWWWWWWWWWWWWWWWWWWWWWWWWWWWWWW
WWWWWWWWWWWWWWWWWWWWWWWWWWWWWWWW
:F fondo_marble2.png
:M marble.mp3
:W marble2.png