WWWPWWWWWWWWWWWWWWWWWWWWWWWWWWWW
WWW WWWWWWWWWWWWWWWWWWWWWWWWWWWW
WW                    WWWWWWWWWW
WW                     WWWWWWWWW
WW     F                WWWWWWWW
WW          F          WWWWWWWWW
WWWW             F      WWWWWWWW
WWG    B              F WWWWWWWW
WWW    F    B                WWW
WW          F    B        D  WWW
WW               F    BWWWWWWWWW
WW                    F WWWWWWWW
WW                      WWWWWWWW
WW                      WWWWWWWW
WW                      WWWWWWWW
WW                      WWWWWWWW
WW                      WWWWWWWW
WW                      WWWWWWWW
:Fondo fondo_marble2.png
:Musica BondEsque.wav
:Pared marble.png
:Graviswitch False
:G_Spin 3