WWWPWWWWWWWWWWWWWWWWWWWWWWWWWWWW
WWW WWWWWWWWWWWWWWWWWWWWWWWWWWWW
WW             S        S     WW
WW                            WW
WW    S     S                 WW
WW                S           WW
WWWW                        D WW
WWGF     JF    JF F     JF  WWWW
WWW                           WW
WW                            WW
WW                            WW
WW                            WW
WW                            WW
WW                            WW
WW                            WW
WW                            WW
WW                            WW
WW                            WW
:Fondo fondo_marble2.png
:Musica BondEsque.wav
:Pared marble.png
:Graviswitch False
:G_Spin 4