WPWWWWWWWWWWWWWWWWWWWWWWWWWWWWWW
W WWWWWWWWWWWWWWWWWWWWWWWWWWWWWW
W WWWWWWWWWWWWWWWWWWWWWWWWWWWWWW
W WWWWWWWWWWWWWWWWWWWWWWWWWWWWWW
W WWWWWWWWWWWWWWWWWWWWWWWWWWWWWW
W WWWWWWWWWWWWWWWWWWWWWWWWWWWWWW
W WWWWWWWWWWWWWWWWWWWWWWWWWWWWWW
W WWWWWWW              WWWWWWWWW
W WWWWWWW           D  WWWWWWWWW
W WWWWWWW     W   WWWWWWWWWWWWWW
W WWWWWWW  W          WWWWWWWWWW
W            W  W     WWWWWWWWWW
W                W    WWWWWWWWWW
W                   WWWWWWWWWWWW
W          W  W WWWWWWWWWWWWWWWW
W       W       WWWWWWWWWWWWWWWW
W  W   WWW      WWWWWWWWWWWWWWWW
WWWWWWWWWWWWWWWWWWWWWWWWWWWWWWWW
:F fondo_marble.png
:M marble.mp3
:W wallmarble.png