WPWWWWWWWWWWWWWWWWWWWW        WW
W WWWWWWWWWWWWWWWWWWWWWWW     WW
W WWWWWWWWWWWWWWWWWWWWWWWW     W
W WWWWWWWWWWWWWWWWWWWWWWWWW     
W WWWWWWWWWWWWWWWWWWWWWWWWWWW   
W WWWWWWWW  WWWWW WWWWWWWWWWWWW 
W WWWWWWW   W        W WWWWWWWWW
W WWWWWWW              WWWWWWWWW
W WWWWWWW           D  WWWWWWWWW
W WW WWWW     W   WWWWWWWWWWWWWW
W  W W WW  W          WWWWWWWWWW
W      W     W WW     WWWWWWWWWW
W                W    WWWWWWW   
W                   WWWWWWWW    
W          W  W WWWWWWWWWWWW    
W       W       WWWWWWWWWWWW    
W  W   WW W     WWWWWWWWWWWWW   
WWWWWWWWWWWWWWWWWWWWWWWWWWWWWWW 
:F fondo_marble.png
:M marble.mp3
:W wallmarble.png