WWWWWWWWWWWWWWWWWWWWWWWWWWWWWWWW
WWWWWWWWWWWWWWWBWBWBBBWWWWWWWWWW
WWWWWWWWWWWWWWW       WWWWWWWWWW
WWWWWWWWWWWWWWW       WWWWWWWWWW
WWWWWWWWWBWW          WWWWWWWWWW
WWWWWWWWW WW          WWWWWWWWWW
WWWWWWWWW WW          WWWWWWWWWW
WWWWWWWWW WW             WWWWWWW
WWWWWWWWW WW           D WWWWWWW
WWWWWWWWW WW          WWWWWWWWWW
WWWWWWW               WWWWWWWWWW
WWWWWWW              WWWWWWWWWWW
WWWWWWW  P          WWWWWWWWWWWW
WWWWWWWWWWWWWW     WWWWWWWWWWWWW
WWWWWWWWWWWWSSSSSSSSSSWWWWWWWWWW
WWWWWWWWWWWWWWWWWWWWWWWWWWWWWWWW
WWWWWWWWWWWWWWWWWWWWWWWWWWWWWWWW
WWWWWWWWWWWWWWWWWWWWWWWWWWWWWWWW
:F fondo_marble2.png
:M Bond Esque.wav
:W marble.png
:G False