WWWWWWWWPWWWWWWWWWWWWWWWWWWWWWWW
WWWWWWWW WWSSSSSSSSWWWWWWWWWWWWW
WWWWWWWW WW  F       SWWWWWWWWWW
WWWWWWWW WW  FC      SWWWWWWWWWW
WWWWWWWW WW  WWWFS   SWWWWWWWWWW
WWWWWWWW WW  WWWJS   SWWWWWWWWWW
WWWWWWWW WW  WWW SS  SWWWWWWWWWW
WWWWWWWW WW  WWW S   SWWWWWWWWWW
WWWWWWWW WW SWWW S   SWWWWWWWWWW
WWWWWWWW WW  WWW S   SWWWWWWWWWW
WWWWWWWW WW  WWW S   SWWWWWWWWWW
WWWWWWWW WW  WWW S   SWWWWWWWWWW
WWWWWWWW WW  WWW S  SWWWWWWWWWWW
WWWWWWWW WW  WWWWS   SWWWWWWWWWW
WWWWWWWW WW  WWWWS   SWWWWWWWWWW
WWWWWWWWFW   WWWWS   SWWWWWWWWWW
WWWWWWWW    JWWWWS       D WWWWW
WWWWWWWWWWWWWWWWWWWWWWWWWWWWWWWW
:Fondo fondo_marble2.png
:Musica AdventureHO2.mp3
:Pared marble.png