WWWWWWWWWWWWWWWWWWWWWWWWWWWWWWWW
WWWWWWWWBBWWWWWB B B B B WWWWWWW
WWWWWWWW  WWWW            WWWWWW
WWWWWWWW  WWWB             WWWWW
WWWWWWWW  WWW              WWWWW
WWWWWWWW  WWW               WWWW
WWWWWWWW  WWW               WWWW
WWWWWWWW  WW              D WWWW
WWWWWWWW  W              WWWWWWW
WWWWWWWW  W            F WWWWWWW
WWWWWWWW  WW         F   WWWWWWW
WWWWWWWWFFWW       F     WWWWWWW
WWWWWWWW  F      F       WWWWWWW
WWWWWWWW  F    F         WWWWWWW
WWWWWWWWP FB F           WWWWWWW
WWWWWWWWWWWWSSSSSSSSSSSSSWWWWWWW
WWWWWWWWWWWWWWWWWWWWWWWWWWWWWWWW
WWWWWWWWWWWWWWWWWWWWWWWWWWWWWWWW
:Fondo fondo_marble2.png
:Musica BondEsque.wav
:Pared marble.png
:Graviswitch False