WWWWWWWWWWWWWSWWWWSSWWWWWWWWWWWW
WWWD                     SSSS WW
WWWWWWWWWWWWWW F      F JS   WWW
WWW           FJF     WWWW   WWW
WWW  WF WWWWWWWF             WWW
WWW  WJF                     WWW
WWW   WW W WWWWWW            WWW
WWWSSSSSSSSSSSSSSS F  C      WWW
WWWWWWWWWWWWWWWWWWWJWWWWWW   WWW
WWW              FFF         WWW
WWW              FB          WWW
WWW         F    WWWWWWWWWWWWWWW
WWW        FJF   SWWWWWWWWWWWWWW
WWW         F    SWWWWWWWWWWWWWW
WWW             FSWWWWWWWWWWWWWW
WWW     F      FJSSWWWWWWWWWWWWWW
WWWP   FJSSSSSSSSSWWWWWWWWWWWWWW
WWWWWWWWWWWWWWWWWWWWWWWWWWWWWWWW
:Fondo fondo_marble2.png
:Musica AdventureHO2.mp3
:Pared marble.png