    WWWWWWWWWWWWWWWWWWWW       
    WSSSJFJFJFJFJFJFJFJW       
    WSS F F F F F F F FW        
    WS               P W       
    WS                 W       
    WS  FJFJFJFJFJFJFJFW        
    WS   FJFJFJFJFJFJFJW        
    WS    F F F F F F FW        
    WS                 WWWWW    
    WS                     W    
    WS                     W    
    WSF                   FW   
    WSB                    W    
    WSSSSSSSSSSSSSSSSSSS  FW    
    WFF                  F W    
    WDB                   SW     
    WWSSSSSSSSSSSSSSSSSSSSSW    
    WWWWWWWWWWWWWWWWWWWWWWWW    
:Fondo fondo_marble2.png
:Musica AdventureHO2.mp3
:Pared marble.png
