WWWPWWWWWWWWWWWWWWWWWWWWWWWWWWWW
WWW WWWWWWWWWWWWWWWWWWWWWWWWWWWW
WW                    W JJJJWWWW
WW                      FFFF   W
WW                            WW
WW                      FFFF WWW
WW     F                JJJJ WWW
WW          F           WWWW WWW
WWWW             F      WWWW WWW
WWG    B              F WWWW WWW
WWW    F    B           WWWW WWW
WW          F    B      WWWW WWW
WW               F    J WWWW WWW
WW                    F WWW   WW
WW                      WWW D WW
WW                      WWWWWWWW
WW                      WWWWWWWW
WW                      WWWWWWWW
:Fondo fondo_marble2.png
:Musica BondEsque.wav
:Pared marble.png
:Graviswitch False
:G_Spin 3