WWWWWWWWWWWWWWWWWWWWWWWWWWWWWWWW
WWW         FJJJJJJJJJJJJWWWWWWW
WWW          FFFFFFFFFFFFWWWWWWW
WWW          FFFFFFFFFF  WW   WW
WWW        WWJJJJJJJJJJF WDB  WW
WWW       WWWWWWWWWWWWW  WWW  WW
WWW     WWWWWWW       W  WWW  WW
WWW WWWWWWWWWW        W  WWW  WW
WWW WWWWWWWWWW        W       WW
WWW WWWWWWWWW         W       WW
WWWB                  W  WWW  WW
WWWWWWWWW             W  WWWSSWW
WWWWWWWWWWWWW         W  WWWWWWW
WWWWWWWWWWWWWWWWWW    WFFWWWWWWW
WWWWWWWWWWWWWWWWWW    WJJWWWWWWW
WWW         F    W  B WWWWWWWWWW
WWW   P     F       BBWWWWWWWWWW
WWWWWWWWWWWWWWWWWWWWWWWWWWWWWWWW
:Fondo fondo_marble2.png
:Musica AdventureHO2.mp3
:Pared marble.png