WPWWWWWWWWWWWWWWWWWWWW        WW
W W      WWWWWWWWWWWWWWWW     WW
W W      WWWWWWWWWWWWWWWWW     W
W W      WWWWWWWWWWWWWWWWWW     
W W      WWWWWWWWWWWWWWWWWWWW   
W WWWWWWWW  WWWWW WWWWWWWWWWWWW 
W WWWWWWW   W        W WWWWWWWWW
W WWWWWWW              WWWWWWWWW
W WWWWWWW           D  WWWWWWWWW
W WW WWWW     W   WWWWWWWWWWWWWW
W  W W WW  W          WWWWWWWWWW
W      W     W WW     WWWWWWWWWW
W                W    WWWWWWW   
W                   WWWWWWWW    
W          W  W WWWWWWWWWWWW    
W       W       WWWWWWWWWWWW    
W  W   WW W     WWWWWWWWWWWWW   
WWWWWWWWWWWWWWWWWWWWWWWWWWWWWWW 
:Fondo fondo_marble1.png
:Musica BondEsque.wav
:Pared marble.png
:Graviswitch False