WWWWWWWWWWWWWWWWWWWWWWWWWWWWWWWW
WWWWWWWWWWW   WWWWWWWWW WWWWWWWW
WWWWWWWWW       WWWWWWW WWWWWWWW
WW   WWW         WWWWWW W     WW
WW          G         FBF  D  WW
WWW  WWWWWWWWWWWWWWWWWWWWWWWWWWW
WWWW  W WWWW WWWW WWWW WWWW   WW
WWWS                      B  CWW
WWWWWWWWWWWWWWWWWWWWWWWWWWW  WWW
WW   WWW WWW WWW WWW WWW W  WWWW
WWC                       B SWWW
WWW  WWWWWWWWWWWWWWWWWWWWWWWWWWW
WWWW  WW WW WW WW WW WW   WWWWWW
WWWS                  B  CWWWWWW
WWWWWWWWWWWWWWWWWWWWWWW  WWWWWWW
WW P                    WWWWWWWW
WWWWWWWWWWWWWWWWWWWWWWWWWWWWWWWW
WWWWWWWWWWWWWWWWWWWWWWWWWWWWWWWW
:Fondo fondo_marble2.png
:Musica BondEsque.wav
:Pared marble.png
:Graviswitch False
:G_Spin 4
#:G_Spin_spd 120