WWWWWWWWWWWWWWWWWWWWWWWWWWWWWWWW
WWWWWWWWW  W F     WWWWWWWWWWWWW
WWWWWWWWWP W F C   WWWWWWWWWWWWW
WWWWWWWWWW W WWWWFWWWWWWWWWWWWWW
WWWWWWWWW  W  WW B WWWWWWWWWWWWW
WWWWWWWWW  W  WW W WWWWWWWWWWWWW
WWWWWWWWW WW  WWB BWWWWWWWWWWWWW
WWWWWWWWW  WW WWWFWWWWWWWWWWWWWW
WWWWWWWWW  W  WW   WWWWWWWWWWWWW
WWWWWWWWWWBW  WW WBWWWWWWWWWWWWW
WWWWWWWWW  W  WWB BWWWWWWWWWWWWW
WWWWWWWWW WW WWWFWWWWWWWWWWWWWWW
WWWWWWWWW  W  WW  WWWWWWWWWWWWWW
WWWWWWWWW  W  WW  WWWWWWWWWWWWWW
WWWWWWWWWW W  W   WWWWWWWWWWWWWW
WWWWWWWWW  WW W   WWWWWWWWWWWWWW
WWWWWWWWW     W D WWWWWWWWWWWWWW
WWWWWWWWWWWWWWWWWWWWWWWWWWWWWWWW
:Fondo fondo_marble2.png
:Musica AdventureHO2.mp3
:Pared marble.png