WWWWWWWWWWWWWWWWWWWWWWWWWWWWWWWW
WWW         FJJJJJJJJJJJJWWWWWWW
WWW         FFFFFFFFFFFFFWWWWWWW
WWW         FFFFFFFFFFFF WW   WW
WWW        WWJJJJJJJJJJF WDB  WW
WWW       WWWWWWWWWWWWW  WWW  WW
WWW     WWWWW         W  WWW  WW
WWW WWWWWWWWW         W  WWW  WW
WWW WWWWWWWWW         W  WWW  WW
WWW WWWWWWWWW         W       WW
WWWB                  W       WW
WWWWWWWWW             W  WWW  WW
WWWWWWWWWWWWW         W  WWWSSWW
WWWWWWWWWWWWWWWWWW    WFFWWWWWWW
WWWWWWWWWWWWWWWWWW    WJJWWWWWWW
WWW         F    W  B WWWWWWWWWW
WWW   P     F       BBWWWWWWWWWW
WWWWWWWWWWWWWWWWWWWWWWWWWWWWWWWW
:F fondo_test1.png
:M smb3world1.mp3
:W grey1.png