WWWWWWWWWWWWWWWWWWWWWWWWWWWWWWWW
WWWWWWWWWWW   WWWWWWWWW WWWWWWWW
WWWWWWWWW       WWWWWWW WWWWWWWW
WW   WWW    G    WWWWWW W     WW
WW          W         FBF  D  WW
WWW  WWWWWWWWWWWWWWWWWWWWWWWWWWW
WWWW  WW  WW  WW  WW  WWWWW   WW
WWWS                      B  CWW
WWWWWWWW WWW WWW WWW WWWWWW  WWW
WW   WW  WWW   W WW  WWW W  WWWW
WWC                       B SWWW
WWW  WWW WWWWW WWWWW WWWWWWWWWWW
WWWW  WW WW  W WW  W WW   WWWWWW
WWWS                  B  CWWWWWW
WWWWWWWWWWW WWWWW WWWWW  WWWWWWW
WW P                    WWWWWWWW
WWWWWWWWWWWWWWWWWWWWWWWWWWWWWWWW
WWWWWWWWWWWWWWWWWWWWWWWWWWWWWWWW
:Fondo fondo_marble2.png
:Musica AdventureHO2.mp3
:Pared marble.png
:Graviswitch False
:G_Spin 4
#:G_Spin_spd 120