WWWWWWWWWWWWWWWWWWWWWWWWWWWWWWWW
WWWWWWWWBBWWWWWB B B B B WWWWWWW
WWWWWWWW  WWWW            WWWWWW
WWWWWWWW  WWWB             WWWWW
WWWWWWWW  WW               WWWWW
WWWWWWWW  WW                WWWW
WWWWWWWW  WW                WWWW
WWWWWWWW  WW              D WWWW
WWWWWWWW  WW             WWWWWWW
WWWWWWWW  WW           F WWWWWWW
WWWWWWWW  W          F   WWWWWWW
WWWWWWWWFFW        F     WWWWWWW
WWWWWWWW  F      F       WWWWWWW
WWWWWWWW  F    F         WWWWWWW
WWWWWWWWP FB F           WWWWWWW
WWWWWWWWWWWWSSSSSSSSSSSSSWWWWWWW
WWWWWWWWWWWWWWWWWWWWWWWWWWWWWWWW
WWWWWWWWWWWWWWWWWWWWWWWWWWWWWWWW
:Fondo fondo_marble2.png
:Musica BondEsque.wav
:Pared marble.png
:Graviswitch False