WWWWWWWWWWWWWWWWWWWWWWWWWWWWWWWW
WWWWWW               WWWWWWWWWWW
WW                     WWWWWWWWW
WW P                    WWWWWWWW
WWWWWWWW  W              WWWWWWW
WWWWW         W   W      WWWWWWW
WWWWWW                    WWWWWW
WWWW                       WWW W
WWWW                        WWWW
WWW                          WWW
WWW                         WWWW
WWW                        WWWWW
WWW                        WWWWW
WWW                         WWWW
WW                         D WWW
W                        WWWWWWW
W                          WWWWW
W                           WWWW
:F fondo_marble.png
:M marble.mp3
:W wallscrapbrain.png