WWWWWWWWWWWWWWWWWWWWWWWWWWWWWWWW
WWWWWWWWWWWWWWWWWWWWWWWWWWWWWWWW
WWWWWWWWWWWWWWWWWWWWWWWWWWWWWWWW
WWWWWWWWWWWWWWWWWWWWWWWWWWWWWWWW
WWWWWWWWWWWWWBWWWWWWWWWWWWWWWWWW
WWWWWWWWWWWWW WWWWWWWWWWWWWWWWWW
WWWWWWWWWWWWW WWWWWWWWWWWWWWWWWW
WWWWWWWWWWWWW WWWWWWWWWWWWWWWWWW
WWWWWWWWWWWWW WWWWWWWWWWWWWWWWWW
W                            WWW
W                           WWWW
W            P             WWWWW
WWWWWWWWWWWWWWWWWWWWWWWWWWWWWWWW
WWWWWWWWWWWWWWWWWWWWWWWWWWWWWWWW
WWWWWWWWWWWWWWWWWWWWWWWWWWWWWWWW
WWWWWWWWWWWWWWWWWWWWWWWWWWWWWWWW
WWWWWWWWWWWWWWWWWWWWWWWWWWWWWWWW
WWWWWWWWWWWWWWWWWWWWWWWWWWWWWWWW
:F fondo_marble2.png
:M cheetah.mp3
:W scrap2.png
:G False