WWWWWWWWWWWWWWWWWWWWWWWWWWWWWWWW
WWWWWW    WWWWWWWWWWWWWWWWWWWWWW
WWWWWW P  WWWWWWWWWWWWWWWWWWWWWW
WWWWWWWWW WWWWWWWWWWWW   WWWWWWW
WWWWWW WW WWWWWWWWWWW   WWWWWWWW
WWWWW     WWWWWWWWWWW     WWWWWW
WWWWWW    WWWWWWWWWWWW   WWWWWWW
WWWWWW    WWWWWWWWWWWWWW WWWWWWW
WWWWWW WW WWWWWWWWWWWWWWWWWWWWWW
WWWWWW WWSWWWWWWWWWWWWWWWWWWWWWW
WWWWWW    WWWWWWWWWWWWWWWWWWWWWW
WWWWWW    WWWWWWWWWWWWWWWWWWWWWW
WWWWWW WW WWWW WWWWWWWWWWWWWWWWW
 WWWWWSWW WWWW W WWWWWWWWWWWWWWW
  WWWWWWW    W   WWW WWWWWWWWWWW
  WWWWWWW W      W    WWWWWWWWWW
 WWWWWWWWSW        D WWWWWWWWWWW
 WWWWWWWWWWWWW   WWWWWWWWWWWWWWW
:F fondo_marble.png
:M marble.mp3
:W marble2.png