WWWWWWWWWWWWWWWWWWWWWWWWWWWWWWWW
WWW         F            WWWWWWW
WWW         F            WWWWWWW
WWW         WWWWWWWWWWW  WW   WW
WWW        WWWWWWWWWWWW  WDB  WW
WWW       WWW         W  WWW  WW
WWW     WWWWW         W  WWW  WW
WWW WWWWWWWWW         W  WWW  WW
WWW WWWWWWWWW         W  WWW  WW
WWW WWWWWWWWW         W       WW
WWWB                  W       WW
WWWWWWWWW             W  WWW  WW
WWWWWWWWWWWWW         W  WWWSSWW
WWWWWWWWWWWWWWWWWW    WFFWWWWWWW
WWWWWWWWWWWWWWWWWW    WJJWWWWWWW
WWW         F    W  B WWWWWWWWWW
WWW   P     F       JBWWWWWWWWWW
WWWWWWWWWWWWWWWWWWWWWWWWWWWWWWWW
:F fondo_test1.png
:M smb3world1.mp3
:W wall2.png